0000000000000
2000000000002
1111200021111
1122443442211
0001443441000
0001000001000
1111000001000
2111000001112
2111110111112
2111000001112
2330011100332
2330015100332